{
    "floor_count": 10,
    "capacity": 6,
    "floor_requests": {
        "1": [2, 2, 2, 2, 2, 2, 2, 2, 2, 2, 2, 2],
        "2": [3, 3, 3, 3, 3, 3, 1, 1, 1, 1, 1, 1, 3, 3, 3, 3, 3, 3],
        "3": [4, 4, 4, 4, 4, 4, 2, 2, 2, 2, 2, 2],
        "4": [5, 5, 5, 5, 5, 5, 3, 3, 3, 3, 3, 3],
        "5": [6, 6, 6, 6, 6, 6, 4, 4, 4, 4, 4, 4],
        "6": [7, 7, 7, 7, 7, 7, 5, 5, 5, 5, 5, 5],
        "7": [8, 8, 8, 8, 8, 8, 6, 6, 6, 6, 6, 6],
        "8": [9, 9, 9, 9, 9, 9, 7, 7, 7, 7, 7, 7],
        "9": [10, 10, 10, 10, 10, 10, 8, 8, 8, 8, 8, 8],
        "10": [9, 9, 9, 9, 9, 9]
    }
}